GrdataProcmenu = widget_button(menubar, value='重力场数据处理', /menu)
  DisturbPara = widget_button(GrdataProcmenu, value='扰动重力场元点值计算',event_pro='DisturbParaEvent', uname='DisturbPara',/separator)
  NormalGrafd = widget_button(GrdataProcmenu, value='正常重力场元点值计算',event_pro='NormalGrafdEvent', uname='NormalGrafd')
  ModelGravfd = widget_button(GrdataProcmenu, value='模型重力场元点值计算',event_pro='ModelGravfdEvent', uname='ModelGravfd')
  EllipAdjust = widget_button(GrdataProcmenu, value='椭球面或球面边值校正',event_pro='EllipAdjustEvent', uname='EllipAdjust',/separator)
  MolodeskyIntg = widget_button(GrdataProcmenu, value='Molodensky边值改正',event_pro='MolodeskyIntgEvent', uname='MolodeskyIntg')
  EllipchgAdj = widget_button(GrdataProcmenu, value='扰动场元正常椭球变换',event_pro='EllipchgAdjEvent', uname='EllipchgAdj')
  MultiGragrd = widget_button(GrdataProcmenu, value='不同高度多种场元融合',event_pro='MultiGragrdEvent', uname='MultiGragrd',/separator)
  ;MultiHgtGrav = widget_button(GrdataProcmenu, value='不同高度离散场元融合',event_pro='MultiHgtGravEvent', uname='MultiHgtGrav')
  ContinuGrad = widget_button(GrdataProcmenu, value='径向梯度法解析延拓',event_pro='ContinuGradEvent', uname='ContinuGrad',/separator)
  HorGradient = widget_button(GrdataProcmenu, value='格网水平梯度向量估计',event_pro='HorGradientEvent', uname='HorGradient',/separator)
  GrdLowpFltr = widget_button(GrdataProcmenu, value='格网数据低通滤波运算',event_pro='GrdLowpFltrEvent', uname='GrdLowpFltr')
  StatistInfor = widget_button(GrdataProcmenu, value='文件数据统计信息提取',event_pro='StatistInforEvent', uname='StatistInfor',/separator)
 ;
  TerrainInfmenu = widget_button(menubar, value='地球外部地形影响', /menu)
  LTerInfluNintg = widget_button(TerrainInfmenu, value='局部地形影响数值积分',event_pro='LTerInfluNintgEvent', uname='LTerInfluNintg',/separator)
  LTerInfluenFFT = widget_button(TerrainInfmenu, value='局部地形影响积分 FFT',event_pro='LTerInfluenFFTEvent', uname='LTerInfluenFFT')
  TrinfluenPlate = widget_button(TerrainInfmenu, value='陆海重力平面布格影响',event_pro='TrinfluenPlateEvent', uname='TrinfluenPlate',/separator)
  TrinfluGlcrust = widget_button(TerrainInfmenu, value='球壳地形质量影响计算',event_pro='TrinfluGlcrustEvent', uname='TrinfluGlcrust')
  HCompenstNintg = widget_button(TerrainInfmenu, value='局部地形质量补偿积分',event_pro='HCompenstNintgEvent', uname='HCompenstNintg',/separator)
  HCompensateFFT = widget_button(TerrainInfmenu, value='局部地形质量补偿 FFT',event_pro='HCompensateFFTEvent', uname='HCompensateFFT')
  OWtBougueNintg = widget_button(TerrainInfmenu, value='海水完全布格影响积分',event_pro='OWtBougueNintgEvent', uname='OWtBougueNintg',/separator)
  OWatrBougueFFT = widget_button(TerrainInfmenu, value='海水完全布格影响 FFT',event_pro='OWatrBougueFFTEvent', uname='OWatrBougueFFT')
  LakeBougueInfl = widget_button(TerrainInfmenu, value='江河湖库布格影响积分',event_pro='LakeBougueInflEvent', uname='LakeBougueInfl')
  IsostInflNintg = widget_button(TerrainInfmenu, value='陆海地面重力均衡影响',event_pro='IsostInflNintgEvent', uname='IsostInflNintg',/separator)
  GlobalterrHarm = widget_button(TerrainInfmenu, value='陆海地形质量球谐分析',event_pro='GlobalterrHarmEvent', uname='GlobalterrHarm',/separator)
  GlHarmTerrInfl = widget_button(TerrainInfmenu, value='完全布格影响球谐计算',event_pro='GlHarmTerrInflEvent', uname='GlHarmTerrInfl')
  ;
  GravfdIntgmenu = widget_button(menubar, value='扰动场元积分运算', /menu)
  StokesNumintg = widget_button(GravfdIntgmenu, value='广义Stokes数值积分',event_pro='StokesNumintgEvent', uname='StokesNumintg',/separator)
  StokesFFTintg = widget_button(GravfdIntgmenu, value='广义Stokes积分 FFT',event_pro='StokesFFTintgEvent', uname='StokesFFTintg')
  HotineNumintg = widget_button(GravfdIntgmenu, value='广义Hotine数值积分',event_pro='HotineNumintgEvent', uname='HotineNumintg')
  HotineFFTintg = widget_button(GravfdIntgmenu, value='广义Hotine积分 FFT',event_pro='HotineFFTintgEvent', uname='HotineFFTintg')
  VManomalyNint = widget_button(GravfdIntgmenu, value='广义V_M空间异常积分',event_pro='VManomalyNintEvent', uname='VManomalyNint',/separator)
  VManomalyFFT = widget_button(GravfdIntgmenu, value='广义V_M空间异常 FFT',event_pro='VManomalyFFTEvent', uname='VManomalyFFT')
  VMdisturbNint = widget_button(GravfdIntgmenu, value='广义V_M扰动重力积分',event_pro='VMdisturbNintEvent', uname='VMdisturbNint')
  VMdisturbFFT = widget_button(GravfdIntgmenu, value='广义V_M扰动重力 FFT',event_pro='VMdisturbFFTEvent', uname='VMdisturbFFT')
  AnStokesNint = widget_button(GravfdIntgmenu, value='高程异常逆远算数值积分',event_pro='AnStokesNintEvent', uname='AnStokesNint',/separator)
  AnStokesFFT = widget_button(GravfdIntgmenu, value='高程异常逆远算积分 FFT',event_pro='AnStokesFFTEvent', uname='AnStokesFFT')
  AnVMdeflNint = widget_button(GravfdIntgmenu, value='垂线偏差逆远算数值积分',event_pro='AnVMdeflNintEvent', uname='AnVMdeflNint')
  AnVMdeflFFT = widget_button(GravfdIntgmenu, value='垂线偏差逆远算积分 FFT',event_pro='AnVMdeflFFTEvent', uname='AnVMdeflFFT')
  RadiGradNint = widget_button(GravfdIntgmenu, value='场元径向梯度数值积分',event_pro='RadiGradNintEvent', uname='RadiGradNint',/separator)
  RadiGradFFT = widget_button(GravfdIntgmenu, value='场元径向梯度积分 FFT',event_pro='RadiGradFFTEvent', uname='RadiGradFFT')
  PossionNint = widget_button(GravfdIntgmenu, value='场元Possion数值积分',event_pro='PossionNintEvent', uname='PossionNint')
  VgradNintg = widget_button(GravfdIntgmenu, value='扰动重力梯度积分运算',event_pro='VgradNintgEvent', uname='VgradNintg',/separator)
  AngradNint = widget_button(GravfdIntgmenu, value='扰动重力梯度的逆运算',event_pro='AngradNintEvent', uname='GAngradNint')
  ;
  ProAppcalcmenu = widget_button(menubar, value='高程基准优化及应用', /menu)
  GeoidNoiseInf = widget_button(ProAppcalcmenu, value='重力大地水准面误差估计',event_pro='GeoidNoiseInfEvent', uname='GeoidNoiseInf',/separator)
  GeoidSystdevt = widget_button(ProAppcalcmenu, value='重力数据的系统偏差影响',event_pro='GeoidSystdevtEvent', uname='GeoidSystdevt')
  DksiwthDhgtmd = widget_button(ProAppcalcmenu, value='高程异常模型径向变化计算',event_pro='DksiwthDhgtmdEvent', uname='DksiwthDhgtmd',/separator)
  DksiwthDhgtms = widget_button(ProAppcalcmenu, value='高程异常径向变化残差精化',event_pro='DksiwthDhgtmsEvent', uname='DksiwthDhgtms')
  HghtsyModlDif = widget_button(ProAppcalcmenu, value='正高与正常高模型差异计算',event_pro='HghtsyModlDifEvent', uname='HghtsyModlDif',/separator)
  HghtsyMsurDif = widget_button(ProAppcalcmenu, value='正高与正常高残余差别精化',event_pro='HeightSysDiffEvent', uname='HeightSysDiff')
  EqhgtsModlDif = widget_button(ProAppcalcmenu, value='等高程面模型重力位计算',event_pro='EqhgtsModlDifEvent', uname='EqhgtsModlDif',/separator)
  EqhgtsMsurDif = widget_button(ProAppcalcmenu, value='等高程面重力位残差精化',event_pro='EqhgtsMsurDifEvent', uname='EqhgtsMsurDif')
  EquiModelptnt = widget_button(ProAppcalcmenu, value='过指定点模型等位面构造',event_pro='EquiModelptntEvent', uname='EquiModelptnt',/separator)
  EquiMsureptnt = widget_button(ProAppcalcmenu, value='过指定点重力等位面精化',event_pro='EquiMsureptntEvent', uname='EquiMsureptnt')
  ;KsiEquipJudge = widget_button(ProAppcalcmenu, value='高程异常的解析相容性评估',event_pro='KsiEquipJudgeEvent', uname='KsiEquipJudge',/separator)
  KsiErEstimate = widget_button(ProAppcalcmenu, value='地面高程异常成果精度评估',event_pro='KsiErEstimateEvent', uname='KsiErEstimate')
  HgtDatumPara =  widget_button(ProAppcalcmenu, value='高程基准零点重力位参数计算',event_pro='HgtDatumParaEvent', uname='HgtDatumPara',/separator)
  GNSSlscalecnt = widget_button(ProAppcalcmenu, value='泊松方程约束GNSS水准融合',event_pro='GNSSlscalecntEvent', uname='GNSSlscalecnt')
  GNSSlNetwkAdj = widget_button(ProAppcalcmenu, value='残差高程异常水准网拟稳平差',event_pro='GNSSlNetwkAdjEvent', uname='GNSSlNetwkAdj')
  WeighFunction = widget_button(ProAppcalcmenu, value='指定参考属性观测量权值计算',event_pro='WeighFunctionEvent', uname='WeighFunction',/separator)
  GNSSlvlcaltor = widget_button(ProAppcalcmenu, value='GNSS代替水准测量计算器',event_pro='GNSSlvlcaltorEvent', uname='GNSSlvlcaltor',/separator)
  GNSSlfileCalc = widget_button(ProAppcalcmenu, value='GNSS代替水准批量点计算',event_pro='GNSSlfileCalcEvent', uname='GNSSlfileCalc')
  ;
  ToolDataEditmenu = widget_button(menubar, value='数据编辑工具', /menu)
  PntflStandard  = widget_button(ToolDataEditmenu, value='点值文件格式标准化',event_pro='PntStandardEvent', uname='PntStandard',/separator)
  GrdvalStandard = widget_button(ToolDataEditmenu, value='标准化格网格值构造',event_pro='GrdvalStandardEvent', uname='GrdvalStandard')
  PntRecatrrCalc = widget_button(ToolDataEditmenu, value='点值属性间加权运算',event_pro='PntRecatrrCalcEvent', uname='PntRecatrrCalc',/separator)
  GrdTwoelemCalc = widget_button(ToolDataEditmenu, value='两格网格值加权运算',event_pro='GrdTwoelemCalcEvent', uname='GrdTwoelemCalc')
  MultiGridadd = widget_button(ToolDataEditmenu, value='系列同规格格网累加',event_pro='MultiGridaddEvent', uname='MultiGridadd')
  TwoVectCalc =  widget_button(ToolDataEditmenu, value='两向量格网的乘积运算',event_pro='TwoVectCalcEvent', uname='TwoVectCalc')
  Vectgridpart = widget_button(ToolDataEditmenu, value='向量格网的两分量分解',event_pro='VectgridpartEvent', uname='Vectgridpart',/separator)
  Vectgridmerg = widget_button(ToolDataEditmenu, value='两格网合并为向量格网',event_pro='VectgridmergEvent', uname='Vectgridmerg')
  GridVForm =    widget_button(ToolDataEditmenu, value='向量格网形式相互转换',event_pro='GridVFormEvent', uname='GridVForm')
  GridtoPntval = widget_button(ToolDataEditmenu, value='向量格网转为离散点值',event_pro='GridtoPntvalEvent', uname='GridtoPntval')
  HarmCSnmadd = widget_button(ToolDataEditmenu, value='两球谐系数模型运算',event_pro='HarmCSnmaddEvent', uname='HarmCSnmadd')
  GridInterpoPnt = widget_button(ToolDataEditmenu, value='格网内插离散点属性',event_pro='GridInterpoPntEvent', uname='GridInterpoPnt',/separator)
  GridatePntCalc = widget_button(ToolDataEditmenu, value='点值简单内插格网化',event_pro='GridatePntCalcEvent', uname='GridatePntCalc')
  MavergeGrid = widget_button(ToolDataEditmenu, value='高分点简单平均格网化',event_pro='MavergeGridEvent', uname='MavergeGrid')
  MFitRBFGrid = widget_button(ToolDataEditmenu, value='指定参数克里金格网化',event_pro='MFitRBFGridEvent', uname='MFitRBFGrid',/separator)
  MwpntKrig2D = widget_button(ToolDataEditmenu, value='加权基函数插值格网化',event_pro='MwpntKrig2DEvent', uname='MwpntKrig2D')
  MwgrdKrig2D = widget_button(ToolDataEditmenu, value='插值法改变格网分辨率',event_pro='MwgrdKrig2DEvent', uname='MwgrdKrig2D')
  SubPickupdata = widget_button(ToolDataEditmenu, value='按经纬度范围提取数据',event_pro='SubPickupdataEvent', uname='SubPickupdata',/separator)
  PickTermValue = widget_button(ToolDataEditmenu, value='按属性条件提取点记录',event_pro='PickTermValueEvent', uname='PickTermValue')
  TwoPntmerdge = widget_button(ToolDataEditmenu,  value='点位相同的两文件合并',event_pro='TwoPntmerdgeEvent', uname='TwoPntmerdge')
  SetValuelnd = widget_button(ToolDataEditmenu, value='格网陆地海洋数据分离',event_pro='SetValuelndEvent', uname='SetValuelnd',/separator)
  Pickerrbgrd = widget_button(ToolDataEditmenu, value='参考面支持的粗差探测',event_pro='PickerrbgrdEvent', uname='Pickerrbgrd')